#########
#S# # # #
#########
# # # # #
#########
# # # #S#
#########
