#########
#S    # #
# ### # #
# #     #
# ##### #
#   #   #
### # # #
#     #E#
#########
