#########
#S    # #
# ### # #
# #   # #
# ##### #
#   #   #
### # # #
#     #E#
#########
