#########
#S# # # #
#########
# # # # #
#########
# # # #E#
#########
